+-+-+-+-+-+-+-+-+-+-+-+-+-+-+-+-+-+-+-+-+-+-+-+-+-+-+-+-+-+-+-+-+-+-+-+-+-+-+-+-+-+-+-+-+-+-+-+-+-+-+-+-+-+-+-+-+-+-+-+-+-+-+-+-+
|S      | |   |         |       |   | |   | |               |         |   |       | |   |     | | |     | | |     |   |         |
+ +-+-+-+ + +-+ +-+-+-+-+ +-+-+-+ + + + +-+ +-+ +-+ + +-+-+-+ +-+-+ + + +-+ + + + + +-+ + + +-+ + +-+ +-+ + +-+ +-+ + +-+-+ + +-+
|       | |       |           |   | |   |         | |     | |   |   | |     | | |         | | |     |   |   | |     | |   | |   |
+-+-+ +-+ +-+ + +-+-+ +-+-+ +-+ + + + + +-+ +-+-+-+-+-+-+ + + +-+ + + +-+-+-+-+ +-+-+ + +-+ + + +-+ + + +-+ + + +-+ + + +-+ +-+-+
|     |       |   | | |         | | | | |   |       | |   |   |   | |   |       |     |   | |   |     |     | |   | | | |       |
+ +-+ + +-+-+-+ + + +-+-+ + +-+ +-+-+ + +-+ + + +-+-+ + + +-+ + +-+-+ +-+ +-+-+-+-+ +-+ +-+-+ +-+-+ +-+ + + + + + +-+ + + +-+-+ +
| | | |     | | | |     | |   | | |   |   |   |       | | |   |   | |     |   |       |   | |   | |   | | |   | | | |     | |   |
+ + + + + +-+ +-+ + +-+ + + + +-+ + +-+-+-+ +-+ +-+-+ + +-+-+-+-+-+ + +-+ + + + + + +-+ + + +-+-+ +-+-+-+ +-+ +-+-+ +-+-+ + +-+-+
| | | | |   |       |   | | |   | |           |   |   |   |       |     | | |   | | | | | | | |       |   | |   |           |   |
+ + +-+ +-+-+ + +-+-+-+ + + +-+-+ +-+-+-+ + +-+-+-+-+ + +-+-+-+-+ +-+-+-+-+ + + +-+-+ +-+ + + +-+-+-+ + +-+ + +-+-+-+ +-+ +-+ +-+
|   |   |     | |     | | | |     |     | | |   |     | | | |       | |   | | | |   |   |     |             |   |   | |       | |
+ +-+-+-+-+ + +-+ +-+-+ + +-+-+ +-+ +-+ +-+ + +-+-+ +-+-+ + + +-+ +-+ + +-+-+-+-+-+ + +-+ +-+-+-+ +-+ + +-+-+ + +-+ +-+-+-+ +-+ +
|           | |       |   | | |   | |         |   | |     | | | |   |   |       |           | |   | | | |   | | |       |     | |
+-+-+ +-+ +-+-+-+-+ +-+-+-+ + +-+ +-+-+ + +-+ + +-+ + + + + + + + +-+-+ +-+ +-+ + +-+-+ +-+-+ +-+-+ +-+ +-+ + +-+ + + +-+ +-+-+ +
|       | |   |   |   |                 |   | | |   | | | | |   |           |   | |     |   |   |   | |   | | |   | |       |   |
+ +-+-+-+ +-+ +-+ + +-+-+-+ + +-+ +-+-+ +-+ +-+ + +-+ +-+ + +-+-+-+ +-+-+-+-+ + +-+-+ +-+ + + + + + + + +-+ +-+ +-+-+ +-+ +-+ +-+
| | | | | |   |     | | | | |   | | |     | |   | |   |       | |       |     | | |       | | | | | |   | |       | | |   |   | |
+-+ + + + +-+ +-+ +-+ + + + +-+-+-+ + + +-+ + +-+-+-+ +-+-+-+ + +-+-+ + +-+-+ + + +-+-+ +-+-+ +-+-+ + +-+ +-+-+-+-+ + +-+ + +-+ +
|             | |   | |   |     |   | |   |         | |   |     |     |   | | | | |                   |       | |     |       | |
+ +-+-+-+-+-+ + + +-+ + + + +-+-+-+ +-+ +-+-+-+-+-+-+-+-+ + +-+-+-+-+-+ + + +-+-+ +-+ + +-+ +-+-+-+-+ + +-+-+-+ +-+ +-+ +-+-+-+ +
| |   | | |     |       | |     |   | |     | |   | |     |   | |     | | | |   |   | | |     |   | |   |   | | |     |   |     |
+ +-+ + + + +-+ +-+-+-+ +-+-+ +-+-+ + +-+ +-+ +-+ + +-+-+ +-+ + + +-+ +-+ + +-+ + +-+-+ + + +-+-+ + + +-+-+ + + + + + + +-+-+ +-+
| |         |     |       | |   | | |       |         |             | | |     |   |     | | |   | |   | |     |   | | |   |     |
+-+-+ +-+ + + + + +-+-+ +-+ + +-+ + +-+ + +-+-+ +-+-+-+ + + + + + +-+ + +-+ +-+ +-+ +-+-+ +-+-+ + + +-+ +-+-+ + +-+ +-+ + +-+ +-+
| | |   | | | | |   |       | |   |     | | |   |   |   | | | | |   | |     |         |   |   |         |         | | | |     | |
+ + + +-+ +-+ + +-+-+-+-+ + +-+ +-+ +-+ + + +-+ + +-+-+-+-+-+-+ +-+-+-+ + + + +-+ + +-+-+-+-+ + +-+ +-+-+ + +-+ +-+ + + +-+-+ + +
|   | |     | |     | |   |     | | | | | | |       |   |   | |   | |   | | | | | |   |   | |   | | |     |   |   | |   |       |
+ + +-+ +-+-+-+ +-+-+ +-+-+ + +-+ +-+ + + + + + + + + + + + + + + + +-+ + + + + +-+ +-+ +-+ + + + +-+ +-+-+ +-+-+-+-+-+-+-+ + +-+
| | | |   |   |         |   |           | |   | | |   |   | |   |     | | | | | | |     |     | |   | | |       |         | | | |
+-+ + +-+-+-+ +-+-+ +-+-+-+ +-+-+-+ +-+-+-+ + +-+-+ +-+ +-+-+ +-+-+-+-+-+ +-+ + + +-+-+ +-+-+ +-+ + +-+ + + + + + +-+ +-+-+-+ + +
|   | |     |   |       |     |       |     |   |     |     |     |   |   |   | |     | | |     | | |     | | | |   |   | | |   |
+-+ + +-+ +-+ +-+-+ +-+-+-+-+-+-+ +-+ + +-+-+ +-+-+ + +-+-+-+ +-+-+ +-+-+ + + + +-+ +-+ + + + + + +-+-+-+-+-+-+-+-+-+ +-+ + +-+ +
|   | |       | |   |   | |     | |   | |   |     | |   | |       | |       | | |         | | |   |   | | | |   |         | |   |
+ + + + +-+ + + + +-+-+ + + +-+ +-+ +-+ + +-+-+-+ +-+-+ + + +-+ +-+ + +-+-+ + + +-+-+ +-+-+-+-+ +-+ +-+ + + + +-+-+-+ + +-+ + + +
| | |   |   | |     | |   | |         | |       | |         | |   |       | |     |   | |         |           |     | |     | | |
+ + +-+ + +-+-+-+-+ + + +-+-+-+ +-+-+-+-+ +-+-+-+-+-+-+-+ +-+ + +-+ +-+ +-+-+-+-+-+ + + +-+-+ +-+-+ +-+-+ +-+ +-+-+ + +-+ +-+ +-+
| |   | |                   |         |       | |       | |   |   | | |         | | |   |     | |   | | | |   |   |   |     |   |
+ +-+ +-+ +-+-+-+-+ + + + +-+-+-+ + + +-+ +-+ + + + +-+-+ +-+ +-+ + + +-+ + +-+ + + + +-+ +-+ + + +-+ + + +-+-+ +-+-+ +-+-+ +-+ +
| |           | | | | | | |   |   | |   | | | |   |             | | | |   |   | |   | |   |   | |   |   | |       |       | |   |
+-+ +-+-+-+-+-+ + + +-+ + + + +-+-+-+-+ + + +-+-+-+-+ +-+ + + +-+-+ + + + + +-+-+-+ +-+-+-+-+ + +-+ + +-+ +-+ +-+ +-+-+ +-+-+ + +
|   |   |         | | | |   | |   | |   |     |     | |   | |   | |   | | | |     | |   |       | | | |   |     |   |       | | |
+ +-+-+ + +-+-+ + + + +-+-+-+-+ +-+ + + + + +-+-+ + + + +-+-+-+-+ +-+ +-+-+-+ +-+-+-+-+ +-+-+ + + + + +-+ +-+ +-+-+-+ +-+-+ + +-+
|   |     | | | |         |   | |   | |   | | |   |   |     |   | | | | | | | |   |       |   |   |   |       | |         |   | |
+ +-+-+-+ + + +-+ +-+ +-+ + +-+ +-+ + +-+ +-+ +-+-+ + +-+-+-+-+ + + +-+ + + + + +-+ + + +-+ + + + +-+-+ +-+-+ + + +-+-+ +-+-+-+ +
| |       |   | | |   |             | |           | | |       |   | | | | | |   |   | | | | | | |   |   | |       | |   |     | |
+ +-+ +-+-+-+ + +-+ + +-+ + +-+-+ +-+ + +-+-+ +-+-+ +-+ + + + + + + + + + + + + +-+ +-+ + +-+ + + +-+ +-+ + +-+-+-+ + +-+ +-+ + +
|   |   | | | | |   | |   |   |     | |   |   |         | | | | |   |       | |       |   | | | | |       |     |     | |   |   |
+ + + +-+ + + + +-+-+ +-+ +-+ + +-+ + + +-+ +-+-+-+ + +-+ +-+-+ +-+-+-+-+ +-+ + + + +-+ +-+ + +-+-+ +-+ +-+-+ +-+-+ +-+ + + +-+-+
| | |       | |   |     |   | | |     |   | | |   | | | | |         | | |     | | | | |   |         |     |     | |       | |   |
+ +-+-+-+-+-+ + +-+ +-+-+ +-+-+ +-+ +-+ +-+ + + + + +-+ + +-+-+ +-+-+ + + +-+-+ + + + +-+ +-+-+-+ + +-+-+-+-+ + + +-+-+-+-+ +-+ +
|   |   |   | |     |   |   |   | | |   | | | | | |   |   | | |       |   | | | | |   |       |   | |       | |   |       | |   |
+ + +-+ + + + +-+ +-+ +-+-+ +-+-+ + +-+-+ + + +-+ + +-+-+ + + + + +-+ + +-+ + +-+ +-+-+-+ + + +-+ + + + +-+-+ +-+ + + + +-+ + +-+
| | | |   | |     |       |   |   |     |   | |         |   | | |   |     |       |       | |   | |   | | |   | | | | |   | |   |
+ +-+ +-+-+ +-+ + + +-+-+-+-+-+-+ + +-+ + +-+ + + +-+-+-+-+ + +-+-+ +-+ + + +-+ + + +-+ + + + +-+-+ + +-+ + +-+ + +-+-+ +-+ +-+ +
|   |       |   |     | | |   |   | | | |       |       |   | | |   |   | | |   | | |   | | |   | | |     |   | | |   |         |
+ +-+ +-+ +-+-+-+ +-+ + + +-+ + +-+ + +-+-+ +-+ +-+-+ + + +-+ + +-+ +-+-+-+-+-+-+-+-+ +-+-+ + +-+ +-+ + +-+-+ + +-+ + + + +-+ +-+
| | | | | | |   | |       |     | |       |   | | |   | | |   |           |   |     | | | | | |   |   | |   |     | |   |   |   |
+-+ +-+ + + +-+ + +-+-+-+ +-+-+ + +-+-+-+-+ + + + +-+-+ + +-+ + + +-+-+-+-+-+ +-+ +-+ + + +-+-+ +-+-+ + + +-+-+ +-+-+-+-+-+ +-+ +
|     |           | |       |     | |     | | |   |   | |     | |   |             |   |   |     | | | | |     | | |   | |   |   |
+ +-+ +-+-+ +-+ +-+ + + +-+ + + + + +-+ +-+ +-+-+-+-+ + +-+-+-+-+-+-+-+-+ +-+-+-+-+ + +-+ + +-+ + + +-+ + + +-+ + +-+ + + +-+ + +
| |   |     |   |     | |     | |     | |           |   |     |   | |       |   |   | |   |   |       |   | |   |       |   | | |
+ +-+ + +-+ +-+-+ +-+ +-+ + +-+-+ + + + +-+ +-+ +-+ +-+ + + + + +-+ +-+ +-+-+ + +-+ +-+-+ + +-+ +-+-+-+-+ +-+-+-+ + + + +-+-+-+ +
| | | | | | |     |     | | |   | | | |       |   | | | | | |         |       | | |       |   |   | |       |     | | |     |   |
+ + + +-+ + + +-+-+-+-+-+-+-+ +-+ +-+-+ +-+ +-+-+-+-+ +-+-+ + +-+ +-+ + +-+-+-+-+ + + +-+ +-+ +-+ + + +-+ + + +-+-+ + + + + +-+ +
| | |       |         | | | |     |   |   | | |     | |   | | |     |     |         |   |   | |     | | | | | |   | | | | | | | |
+-+ +-+-+-+-+-+-+-+-+-+ + + +-+-+-+-+ + +-+ + + +-+ + +-+ +-+-+-+ + +-+ +-+-+-+ +-+-+-+-+-+-+ + +-+-+ + + +-+ + +-+-+-+ +-+ + + +
| |     |     |         |       |     |   | |     |       |   | | | |   |     |     |   | |   |     |   |   |     | |   |   | | |
+ +-+-+ +-+-+ + +-+-+ +-+-+ + +-+ + +-+ + +-+-+-+-+ + + +-+ +-+ + +-+ +-+-+ +-+-+-+ + + + + +-+-+ +-+-+-+-+ + +-+-+ + +-+-+-+ +-+
|   | | | |   |   | |   |   |     |   | | | |     | | |   |   | | |     |         | | | |     | | |     | | | |   |     |       |
+ + + + + + + + + + +-+ +-+-+-+-+ + +-+ +-+ + +-+-+-+ + +-+-+ + + + +-+-+ + + + +-+ +-+ + + + + + + + +-+ + + + + +-+ +-+ +-+ +-+
| |     |   | | |     | |       | | |   |   |   |     | |     |   | |   | | | |     |   | | | |     | |         |   |   | | |   |
+ +-+-+ + +-+-+ +-+ +-+-+-+ + + +-+ +-+ + +-+-+ +-+ +-+-+ +-+-+ +-+-+-+ + +-+-+-+-+ + +-+-+-+-+ +-+ + + + +-+ +-+-+ +-+-+ + +-+ +
| | |     |     | | |       | |         |   |     |         |       |       |   |         | |   |   |   |   |   |   | | |   |   |
+-+ +-+-+ + +-+ + + +-+ +-+ +-+-+-+-+ +-+ +-+ +-+ + +-+-+-+ +-+-+ +-+ +-+-+-+ + +-+ + + + + + +-+ + + +-+-+ + + +-+-+ + + +-+-+ +
| |   |       |   | |   |   |     |       | | |     | |   |   | | | | |   |   |   | | | |     |   | |     | | | |     |   | | | |
+ + +-+-+ +-+-+ +-+ +-+ + +-+-+-+ +-+ + +-+ + +-+-+ + +-+ +-+-+ + + + + +-+-+ +-+-+-+-+ +-+-+-+-+-+-+-+-+ + + + + + +-+ + + + +-+
|         |     |       |     | |   | |     | |             | |       |               | | |       |   |   | | |   |   | | | |   |
+-+-+ +-+ +-+-+ +-+-+-+-+-+-+ + + + + +-+-+-+-+ +-+ +-+ +-+-+ +-+-+ +-+-+ +-+ + + +-+-+ + + + + +-+-+ +-+ +-+ +-+-+ +-+-+ + + +-+
|   | |     |             |     | |   |     |   |     |     |   | |   |   | | | |   |       | | |     | |   |   | | | |         |
+ +-+ +-+ +-+-+ +-+-+-+-+-+-+ +-+ + + +-+-+ + +-+-+ + +-+-+-+ + + +-+ +-+ + +-+-+ +-+-+ + +-+-+ + +-+ + +-+-+-+ + +-+ + +-+-+-+-+
|       |   |     | | |   |   |   | | | |     |   | |   |     | |           |       |   | | | |     |   | |     |   |   |       |
+-+ +-+-+ +-+-+ +-+ + + +-+-+-+ +-+ +-+ +-+ + + +-+ +-+-+ +-+ + + +-+-+-+ +-+-+-+-+-+ + +-+ + +-+ +-+ + + +-+-+ + + + +-+ +-+ +-+
| |   |       |     |     |     |   | |   | |     | | |     | | |     |     | | |   | |   |         | |   |     | |     |   |   |
+ +-+ + +-+-+-+-+-+ +-+ +-+ +-+-+ +-+ + +-+-+-+-+-+ + +-+-+-+-+ + + + +-+ +-+ + +-+ +-+ +-+-+-+-+ +-+-+-+-+ + +-+ + +-+-+-+-+ +-+
|     | |   |   |       |   |   |         |     |     |     | | | | |   | | |   |   |   |       |     | |   | |   |   |     |   |
+-+-+ +-+ + + +-+-+-+-+ +-+-+ +-+ +-+ +-+ + + +-+-+-+ + + +-+ + + + +-+-+ + +-+ + +-+ +-+ +-+ +-+-+ +-+ +-+-+-+-+ +-+-+ +-+-+ + +
|   |   | |     |   |   |   |     |   | |   | |         |   |     | | | |           |   |   |       |     |   |       |     | | |
+-+ + +-+ +-+ +-+ +-+ +-+-+ +-+-+-+ + + + + +-+ + +-+-+ + + + +-+-+ + + +-+-+ +-+ +-+-+-+ + +-+ +-+ +-+-+ + +-+ +-+ +-+ +-+ + +-+
|     |     |         |           | | |   | |   |     | | |     | | |     | | | |       | | |     | |           |     | |   |   |
+ + + +-+-+-+-+-+ +-+ + + +-+ + + +-+-+-+ +-+-+-+ + +-+-+-+ + +-+ + + + +-+ +-+ + +-+ +-+-+ +-+-+ +-+-+ + +-+-+ +-+ +-+-+-+ + + +
| | | | |   | |   | | | | | | | | |   | |         | |       |     | | | |   |   |   |   | | |     |     | | |   |   |         | |
+ + + + + +-+ +-+ + +-+-+ + + +-+-+-+ + +-+-+-+-+ +-+-+-+ + +-+-+-+ + + + +-+-+ +-+ +-+-+ +-+ +-+ + +-+-+-+ +-+-+-+ +-+ + + + +-+
| | | |     |     | |   | |           |         |       | | |       | |       | | | |   |   | |         |   |   |     | | | |   |
+ +-+-+ +-+ + +-+-+ + +-+-+-+ +-+ +-+-+ +-+ + +-+ +-+ +-+ + +-+-+-+-+-+ +-+ +-+ + + + +-+ +-+-+ +-+ +-+-+-+ + + + + +-+ +-+-+-+-+
|   |   | |       | |   |   |   |       |   | | | | | | | | |     |   | |   |       | |     |   |   |   | |   | | |   |   |   | |
+ +-+ +-+ +-+ +-+ + + +-+-+ + +-+-+-+ +-+-+ +-+ +-+ + + +-+-+-+-+ +-+ +-+ + +-+-+-+ + + +-+ +-+ + + +-+ + + +-+-+ +-+-+-+ + + + +
| | | |       |         | |     | | | | | |   | | |   | |       | |       |         |   |   |   | | | |       |     |       |   |
+-+ + +-+-+-+-+ +-+ +-+ + +-+-+-+ + +-+ + +-+ + + +-+-+ + +-+ +-+ + + +-+ + +-+-+ +-+ +-+ +-+-+ +-+ + + + + +-+ +-+ +-+-+-+-+-+ +
|   | | | | | | |   | | |   |     |     |         |         | |     |   | |     |       | |     | |     | |   | |       | | |   |
+ + +-+ + + + +-+-+ + +-+ +-+ + + +-+-+ + +-+-+ + + +-+-+-+ + +-+-+-+-+-+-+ +-+ + +-+-+ +-+-+-+-+ +-+ +-+ +-+ +-+-+ + +-+ + +-+ +
| | |   | |       |   | |   | | | |   | | |   | | |       | |   |             | |   |             | |   |   |     | |   |   | | |
+ +-+ + + + +-+-+-+ +-+ + +-+-+ +-+ + + + + +-+-+-+ + +-+-+-+-+ + + +-+-+-+ +-+-+ + +-+-+ +-+ +-+ + +-+-+-+-+-+ +-+-+-+ +-+ + + +
|     |                 | |       | |       | |     | |   | |   | | | |     |     |   |   |   | | |     | | | | | | |       |   |
+ +-+-+-+-+ +-+-+-+ +-+ + + +-+-+ + +-+-+-+ + + + + +-+-+ + + +-+ + + + +-+ +-+-+ +-+-+-+-+ +-+ + +-+-+ + + + + + + +-+-+ +-+ + +
|       |   | | |   | |         |   | | |   |   | | |   | | |     |   |   | |       |       | |         |   |           |   | | |
+ + +-+-+-+-+ + + + + +-+ + + + +-+ + + +-+ +-+ + +-+-+ + + + +-+-+ +-+ +-+ + +-+ + + + + +-+ +-+-+ + +-+-+ + +-+-+-+-+-+-+-+-+ +
| |             | |   | | | | |   |   |     | | | |       |     | |   | | | |   | | | | | | |       |   |       |     |   | |   |
+-+-+-+ +-+ +-+-+ + +-+ +-+ +-+-+ +-+-+ +-+ + + + +-+ +-+ +-+-+ + + + + + +-+-+ + +-+-+ +-+ +-+ +-+ +-+-+ +-+-+-+ +-+-+ +-+ + +-+
| |   | |     | | |   |   |     |   |     |   | |     |     | | |   | |   |   | | |           | |     |     | |   | | |   |   | |
+ +-+ + +-+-+-+ + + + + +-+-+ + +-+-+ +-+-+-+-+-+-+ +-+ +-+ + + +-+ +-+-+-+ + +-+-+-+ + + + + +-+-+ + + +-+ + +-+ + + + +-+-+ + +
|     | |     |   | |     |   |   | |     |       | |   | | | |   | |       |     |   | | | | | |   | | |   |             | |   |
+-+ + + +-+ +-+-+-+ +-+-+-+-+-+-+-+ +-+-+-+-+-+ +-+-+-+-+ + + + +-+-+-+ +-+ +-+ +-+ +-+-+ +-+-+ +-+-+ + +-+ + + +-+ +-+ + + +-+ +
|   | |           | |     | |     |       |     |       | | |     |       |   | | | |     |         | | |     |   |   | | | |   |
+-+-+ + +-+-+ + +-+ + +-+ + + + + +-+-+ +-+-+-+ +-+ +-+-+ +-+ + + + +-+-+ + +-+ + + +-+-+ +-+ + + + +-+-+-+-+-+-+-+ +-+-+ + + +-+
|   | | |   | | | | | |   | | | | |   |     |           | |   | |       | |   | |   |   |     | | | |     |       | |   | | |   |
+ + + + +-+ +-+ + + + + +-+ + +-+ + +-+ +-+-+-+ + + +-+ + +-+ +-+ +-+-+ + +-+-+-+ + +-+ +-+-+-+-+ +-+-+ + +-+-+-+ + + + +-+ + + +
| |   | |       |     |         |               | | |   |       | |   | |   |     |   |   | |   | |     | |     | |   | |     | |
+-+ +-+-+-+-+ +-+-+ + +-+-+-+ +-+-+-+ + +-+-+ +-+-+-+-+-+-+ +-+-+-+-+ +-+ +-+-+-+-+-+-+ + + +-+ +-+ +-+-+-+ + +-+ + +-+-+ + +-+-+
| |     | | |   |   | |     |       | |     | | | | | | | |             |   | |   | | | |     |   |         | | |         |     |
+ + +-+ + + + +-+ +-+-+ +-+-+ +-+-+ +-+-+ +-+-+ + + + + + +-+-+ +-+ +-+-+ +-+ + + + + + + +-+-+ + +-+-+-+-+-+ + + +-+ + + + +-+ +
| | | | | |   |       | | | |   | | |   |                   |     |     |       | |   | | |   | | |     |   | |   |   | | | |   |
+ +-+ + + + +-+-+ +-+ + + + + +-+ + +-+ + +-+-+ +-+-+-+ +-+-+-+-+ +-+-+-+ +-+ +-+ + +-+-+ + +-+-+ + +-+-+ +-+ +-+-+ +-+ +-+ +-+-+
|             |     | |     |   | |     |     | |         |   |       |   |     |             |       |         |     | | |     |
+ +-+-+ +-+-+-+ + +-+-+ + + + + + + + + +-+ +-+-+-+ +-+ +-+ +-+-+-+-+-+-+ +-+ +-+-+ + + +-+ +-+ +-+-+-+-+-+-+-+ + +-+-+-+ + +-+ +
| |       |   | | |     | |   |   | | |   |   |     | |   |     |   |     |     |   | |   |             | |   |     |     | |   |
+ +-+-+-+ + + +-+-+ + +-+ +-+ +-+-+ + + +-+-+ +-+-+ + +-+ + +-+ +-+ + + +-+ +-+ + + + +-+-+ +-+ + +-+-+ + +-+ +-+-+ + + + +-+-+ +
|     |     |   |   | |   |       | | |     |     |   |     |     |   | |     | | | |     |   | | |     |             | |   |  X|
+-+-+-+-+-+-+-+-+-+-+-+-+-+-+-+-+-+-+-+-+-+-+-+-+-+-+-+-+-+-+-+-+-+-+-+-+-+-+-+-+-+-+-+-+-+-+-+-+-+-+-+-+-+-+-+-+-+-+-+-+-+-+-+-+
 