+-+-+-+-+-+-+-+-+-+-+-+-+-+-+-+-+-+-+-+-+-+-+-+-+-+-+-+-+-+-+-+-+-+-+-+-+-+-+-+-+-+-+-+-+-+-+-+-+-+-+-+-+-+-+-+-+-+-+-+-+-+-+-+-+
|S|             |   | |           |   |   |       |         |     |     | | |   |   | | |   | |     |   | |   | | |     | |   | |
+ +-+-+ +-+-+ +-+-+ + +-+ + + + +-+-+ + +-+ + + + + +-+ +-+-+-+ +-+ +-+-+ + + + + +-+ + + +-+ + + +-+ +-+ + +-+ + + + +-+ +-+ + +
|   |     | |   | |   |   | | |   | | |   | | | | |   | |         |   |   |   | |   |           |                   |           |
+ +-+-+-+-+ + + + +-+ + +-+ + + +-+ + + + + +-+-+-+-+ +-+-+-+-+ +-+ +-+ +-+-+-+ + +-+ +-+-+ + + +-+-+-+-+ +-+-+ + + + + +-+ +-+-+
|   | |       |   |   | | | | |     |   |   |   |               |     |       | |   |   |   | | |   | | | |   | | | | | |   |   |
+-+ + +-+ +-+ +-+ +-+ +-+ +-+-+-+ +-+ +-+ + +-+ + + +-+-+-+-+-+ +-+-+ +-+ +-+-+ + +-+-+ +-+ +-+-+ + + + +-+-+ +-+ +-+-+-+ +-+ + +
|     | | |     |   |   |     |       |   |     | |   |           |     |                 | |   | | |     | |     |   | |     | |
+-+-+ + +-+-+-+-+-+ + +-+ +-+ +-+-+ +-+-+ + + +-+-+ + + +-+-+-+ +-+-+ + +-+ + + + + +-+-+ + + +-+-+ + +-+ + +-+ +-+ +-+ +-+-+ + +
|   |   | | |           | |   |   |     | | |   | | | |       | |   | | | | | | | |   |   | |       | |         |       |   | | |
+ +-+-+ + + +-+ + + +-+-+-+ +-+ +-+-+ +-+ + +-+ + +-+ +-+-+ +-+ + +-+ +-+ +-+ +-+-+-+ + +-+-+-+ +-+ + + + +-+-+-+-+-+-+ +-+ + + +
|         | | | | |   |       |     | |   |   |   | |     | |           | | | |       | | |     |   | | | |   |     |   | |   | |
+-+-+ +-+ + + + + +-+-+ +-+ + + +-+-+-+-+-+-+-+ +-+ + + +-+ + + +-+ +-+ + + + +-+ + +-+-+ + +-+ + + +-+ +-+ +-+ +-+-+-+ + + +-+-+
| | | | | |     |     | |   |   |   | | |         |   |   | | | |   |   |   | |   | |   |   | | | | |     |   |                 |
+ + + + + + +-+-+ +-+ + +-+ + +-+-+ + + + +-+-+ +-+ +-+-+ +-+-+ + +-+ + +-+ + + + + + + + +-+ +-+-+-+-+ +-+ +-+-+-+ +-+ +-+ + +-+
| | | |       | | |     |   | |   | |         |         | |     | | | |     | | | |   | | |   | |   |     |   | | | |     | |   |
+ + +-+-+ +-+-+ +-+-+ + +-+ +-+ +-+ +-+ +-+-+ +-+ +-+-+ +-+-+-+-+ + +-+-+-+ +-+-+-+ + +-+ +-+ + +-+ + +-+ + + + + + +-+-+ +-+-+-+
| | |   | |         | | |         | |   |   |   |   |     |     | | |   |         | |         |       | |   | | |   |           |
+ + + +-+-+ +-+ +-+-+-+-+ + +-+-+-+ + + + +-+-+ + + +-+-+-+-+ +-+-+ +-+ +-+-+ +-+-+-+-+ +-+-+-+-+-+ + + +-+ + + +-+-+-+ +-+-+ +-+
|         | |         |   | | |   |   |   |   | | |     | |     | | | |     |   | | |       |   |   |   | | | |   | |   |   |   |
+ +-+ + +-+-+-+-+ +-+-+ +-+ + + +-+ +-+ +-+-+ + +-+-+-+ + + + +-+ + + + +-+-+-+ + + +-+-+-+-+ + +-+-+-+ + +-+-+-+ + +-+ +-+ +-+ +
|   | |   | |       | | |             |     |     |   |   | |   | | |   |     | |       | | | |         |     |       |   |     |
+ +-+-+ +-+ + + +-+ + +-+-+ +-+-+-+ +-+-+ + +-+ + + +-+-+ + + +-+ + + +-+-+-+ +-+ +-+ +-+ + +-+ + +-+-+-+-+ +-+ +-+ +-+-+ +-+ +-+
| | |         | |   |       |   |       | | |   | |         |       | |     |       | |     | | | | | | | |       | | |   |     |
+ + + +-+-+-+ + +-+-+-+-+ +-+-+ + + +-+-+ + + +-+-+-+-+-+-+ +-+ +-+ + +-+ +-+-+ +-+-+ + +-+ + +-+-+ + + + + +-+-+ + + +-+-+ +-+-+
|   |   |     | |               | |   |   | |             | | |   |     | |         |   |     |         |   | | | |   |         |
+-+ +-+-+-+-+-+-+-+ +-+ + +-+-+-+-+-+ +-+-+ +-+ +-+-+-+ +-+-+ + + +-+-+-+ + +-+ + +-+-+ +-+-+-+ +-+-+-+ +-+-+ + + + +-+-+ +-+-+-+
| |   | | |       | |   |   |   |   |     |   | |         |   | |   | |     |   | |     | |           | |   |     |     | |     |
+ + + + + +-+ +-+ +-+ +-+ +-+ +-+ +-+-+-+ + +-+-+ +-+ + +-+ +-+ +-+-+ + +-+-+-+ +-+-+ + + +-+-+-+-+-+ + + +-+-+ +-+ + + + + +-+-+
| | |         |     | |   |     |         |     | |   | |     |     |     |       |   | |     | | | | |     |   |   | |   |     |
+ + +-+ +-+-+ +-+-+ +-+-+-+ + +-+-+-+ +-+-+ +-+-+-+ + +-+ + +-+-+-+-+ +-+ +-+-+-+-+ +-+-+ +-+ + + + +-+-+ +-+ + +-+-+-+ + +-+ +-+
|   | |   |     | | | |   | |         | |     | | | | |   | | | | |   | |   |     | | |   | |   |   |   |     |     | | | |     |
+-+-+ +-+ +-+-+-+ + + +-+ +-+-+ +-+ +-+ +-+-+-+ + + +-+ + +-+ + + +-+-+ + + + +-+-+ + +-+-+ + +-+ + + + + + +-+ + +-+ +-+ + +-+-+
|         |   | |   |     |     | |     | | |   |   |   | |   |       |   | | | |         |       | | |   |   | | |   | | |   | |
+-+-+ + + +-+ + +-+ +-+ +-+-+ + + + +-+ + + + +-+-+ +-+ + +-+ +-+-+-+ + +-+-+ + +-+-+-+-+ + + + +-+-+-+ +-+ +-+ +-+-+ + +-+ +-+ +
|     | |       | | | |       | |   |   | |     |   |   |   |   | |         | | | |     | | | |   |       | | | |             | |
+ +-+-+-+ +-+-+-+ +-+ + +-+-+-+ +-+-+ +-+ + + +-+ + +-+ +-+ +-+ + + +-+-+ + + + + +-+ +-+-+-+-+-+ + +-+-+ +-+ + +-+-+-+ +-+ +-+ +
| |   | | |           |   |   | |           | | | | |     |     |   | |   |     |   |   |   |   |       | | |     |       |     |
+-+ + + + + + +-+ +-+-+ + + + +-+-+-+-+-+-+-+-+ +-+ + +-+-+ + +-+-+ + +-+-+-+-+-+-+ + +-+ + +-+ +-+ +-+-+-+ +-+-+-+ +-+-+-+-+ +-+
|   |       | |   |   | |   | |   |     |         |   | |   | |   |   |   |           |   |             |     | |   |   |       |
+-+ +-+ +-+-+ + +-+ +-+-+ + +-+ + +-+ +-+-+ +-+-+-+ +-+ + +-+-+ + + +-+ +-+-+ +-+-+-+-+-+-+-+-+-+-+ + +-+-+ +-+ +-+ + +-+ + + +-+
|   |     |   |     |     | | | |     |   | |     |   | |     | |       |   |   |   |     | |       |   | |       |   |   | |   |
+-+-+-+ +-+-+-+ +-+-+ + +-+-+ + +-+-+ + + + +-+ +-+ +-+ +-+-+-+-+ +-+-+ + +-+ + + +-+-+ +-+ + + + +-+ +-+ + +-+-+-+-+ +-+-+-+ +-+
| | |     |         | | |   | |   |     | | | |           | | |     | |   |   |           |   | | |     |     | | | | |   | |   |
+ + + +-+-+ + + + +-+-+-+-+ + +-+-+-+-+ + + + + +-+ + + +-+ + +-+-+ + +-+ + +-+-+ +-+ +-+ + +-+ +-+-+ +-+-+-+ + + + +-+-+ + + +-+
| |       | | | | |   |   |   | |   | | |   |     | | |   |       |     |   | |     | | | |   | | | |     |     |       |   | | |
+ + +-+ + +-+-+-+-+-+ + +-+ +-+ + +-+ +-+ +-+-+-+ + +-+-+ + + +-+-+-+-+-+-+ + +-+ + + + +-+ +-+-+ + +-+ +-+-+-+ +-+ + +-+ +-+ + +
| |   | | |           | |             |       |   | | |   | | | | |       | |     | | |         |   |   | | |       | |       | |
+ + +-+-+ +-+-+ + + +-+ +-+ +-+-+-+-+-+ +-+-+-+-+ + + + +-+-+ + + + +-+ + + +-+-+-+ +-+ + +-+-+-+-+ +-+-+ + + +-+-+-+ +-+-+-+ + +
|     |     |   | |           | | |   |   |     | | |       |         | | | |   |   | | | |   | |         |       |             |
+ +-+-+-+ +-+ +-+-+-+-+-+-+ + + + +-+ +-+ + +-+-+-+-+-+ + + +-+ +-+-+-+ +-+ +-+ +-+ + + +-+ +-+ +-+ +-+-+-+-+ +-+-+-+ + +-+-+ + +
| |         |     |       | | |     | | |   | |   |   | | |   |   |       | |   | |   | |               |     |   |   |   |   | |
+-+-+-+ +-+-+ +-+-+ +-+-+-+-+-+-+ +-+ + +-+ + +-+ +-+ + +-+ +-+-+-+ +-+ +-+-+ +-+ + + + +-+-+ + +-+ +-+ +-+-+ + +-+-+-+-+ + +-+-+
|     |   |   |         |     | |     | |     |   |   | |   |     |   |   |     |   |     | | | |   | |             | | | |     |
+ + +-+ + + +-+-+-+ +-+-+ + +-+ + + +-+ +-+-+ + + + + + + +-+-+-+ +-+-+ +-+-+ +-+ + +-+-+-+ + +-+ + + + +-+-+ +-+-+-+ + +-+ +-+ +
| |   | |       |         | | | | |   |   | | | |   | | |       |             |   |       |     | |   | |       | | |   | | |   |
+ +-+ +-+-+ +-+-+-+ +-+-+ +-+ + + +-+ +-+ + + +-+ + +-+ + +-+ +-+-+ +-+ +-+ +-+ + + +-+-+ + +-+-+-+-+ + +-+-+ +-+ + + +-+ +-+-+-+
|   | |   |   |   | |   |       | |   |     |     | |   |   | | | |   |   |   | | | |   |   |     | | | |       | | |   |     | |
+ + +-+ + +-+ + +-+ + +-+-+ +-+-+ + + + +-+ +-+ + +-+-+ +-+-+-+ + +-+-+ +-+-+-+-+ +-+-+ + +-+ +-+-+ +-+-+-+ +-+ + + +-+ + + +-+ +
| |     |         | |             | | |   |     |   |   |     | | | |               | | | | |       |     | |   | |     | | |   |
+ + + +-+-+-+-+ +-+ +-+-+-+-+-+ +-+ +-+ + +-+-+ +-+-+-+ + + + + + + + +-+ +-+-+ + +-+ + + + + + + + + +-+-+-+-+ + + +-+-+ +-+-+ +
| | | |       |         |         |     |   |           | | |     |   |     |   |       |     | | |   |               |   |     |
+-+ +-+ + +-+-+-+-+-+-+ + +-+-+-+ +-+-+-+-+ +-+-+-+-+ +-+ + +-+ +-+-+ + +-+-+-+-+ +-+-+ +-+-+-+-+-+ +-+-+ + + +-+-+ +-+ +-+ +-+ +
|   | | |         |   | | |   |   | |       |   |   | |   |   |     | |   |       | | | |       |     | | | | |           | |   |
+-+ + + + +-+-+-+-+ + + +-+-+ + +-+ +-+-+ + +-+ +-+ +-+-+-+-+-+-+ +-+-+-+ + +-+-+-+ + + +-+-+-+ +-+-+ + +-+ +-+-+ +-+-+ +-+-+-+ +
|       | |   | | | | | |     | |       | |   |   | |                     | | |       | | |   |         | | | |   |   |   |   | |
+ +-+-+-+ +-+ + + +-+ + + + +-+-+-+-+ +-+ +-+-+ + + + + + +-+ + +-+ + + +-+-+ + +-+ + + + + +-+-+ +-+-+ + +-+ +-+ + + + + + +-+ +
|   | | | |     |         | |     |   |   | | | | |   | | |   | |   | | |         | |     |     |   | |   |   |   | | | |   |   |
+ +-+ + + + + +-+ + + +-+ +-+-+ +-+ + + + + + + + +-+-+-+-+ + +-+-+ +-+-+-+ +-+-+-+ + +-+ +-+ +-+ +-+ +-+-+-+ +-+-+-+ + +-+ + +-+
|   |   | | |     | | | | |     |   |   | |     |       |   | | |     |   | |       | |     |         | |       |   | |   | | | |
+-+ +-+ +-+ + +-+ +-+-+ + + + + + +-+-+-+-+ +-+ +-+-+ + + +-+-+ +-+-+ + + +-+-+-+ +-+-+-+ +-+ +-+-+-+-+ +-+-+-+ + +-+ +-+ + + + +
|     | |   |   | |   |   | | | |           |     |   | |     | |     | |           |     |         |           | | | | | |     |
+-+ +-+ +-+-+ +-+-+-+ +-+ +-+ +-+ + + +-+-+ +-+ +-+ + +-+-+-+ + + +-+-+ +-+ +-+-+-+ +-+-+ +-+-+ +-+ + + +-+ + +-+ + + + +-+-+ + +
| | | |     |   |           |     | |   |   |   |   |   | |     | |       |     | | |         |   | | |   | | |   |     |   | | |
+ +-+ +-+ +-+ +-+ + + +-+ +-+ + +-+-+ +-+-+ +-+ +-+ + +-+ + +-+-+-+-+ + +-+ +-+ + +-+-+-+-+ + + +-+-+-+ +-+-+-+ +-+ + +-+ +-+ +-+
|       |   | |   | | |   |   |   |     | | |     | | |       | | |   | | | | | |   |     | | |     |     |     |   |         | |
+ +-+-+-+ +-+ +-+ +-+-+ +-+ +-+ +-+ + +-+ + +-+-+-+-+ + +-+ +-+ + +-+-+ + + + +-+-+ +-+ + + +-+-+-+-+ +-+ + + +-+-+-+ +-+-+ + + +
|       | |   | | |     | | | | |   |   |   |   |   |   | | | | | |     |       |       |   | |   | | | | | | | |   | |   | |   |
+-+ +-+-+ + +-+ +-+ +-+-+ +-+ +-+-+ +-+ +-+ + + + +-+ +-+ +-+ + + +-+-+-+-+-+ +-+ +-+-+-+ +-+ + + + + + +-+ + + + + +-+-+ + + + +
|   |         |       | | |     | | |     | | |           | |   |         |   |   | |     | |   |       |   | |   | |       | | |
+ + + +-+-+ +-+-+-+ +-+ + + +-+-+ + +-+ + +-+-+-+ + + + +-+ + +-+-+-+ +-+ +-+ +-+-+ +-+-+-+ +-+ + +-+ +-+ + + +-+-+ + +-+-+ +-+ +
| |       |   |       |       | |   | | |   |     | | | |     | |     | | |   |   |       |   | | |   |   | |   |       |   | | |
+-+-+ +-+-+-+ +-+-+-+-+ +-+-+-+ +-+ + +-+-+ +-+ + + +-+-+-+-+ + +-+ +-+ +-+-+-+-+ + +-+ +-+ +-+-+ +-+ +-+-+-+-+ + + +-+ +-+-+ +-+
|       | |       | |   | |   | |       |     | | |     | | |         |               |   | |     | | |       | | |   | |   |   |
+ + +-+ + +-+ +-+ + + +-+ +-+ + + + +-+ + +-+ +-+ + + +-+ + + + +-+ +-+-+-+ +-+ + +-+ +-+-+ +-+ +-+ +-+-+-+-+ + +-+ + + +-+ + + +
| | | | |   | |           | |     | |   |   | | | | | |       | | |       | |   | | |   | |       |   |     |       | | | | | | |
+-+ + +-+-+ + +-+-+ + + +-+ + +-+-+ + + +-+-+-+ +-+ +-+-+ + +-+-+ + +-+ +-+-+ +-+-+ + +-+ +-+ + + + + + +-+ + +-+-+ +-+-+ + + +-+
| |   |           | | |     | |     | |   |       |   |   | |   |     |     | |       |       | | | |   | |   |   |   |         |
+ + +-+-+ +-+-+ +-+ +-+-+-+-+ +-+-+ +-+ +-+ +-+ +-+-+-+-+-+-+-+ +-+ +-+ +-+ + +-+-+ +-+-+-+ + +-+ + +-+-+ + +-+ +-+ +-+ + +-+-+ +
| | |   | |   | |   |   | |     | | |         | |     |     | |     |     | | |       |     |   |   |   |       | | | | |     | |
+ +-+-+ + + +-+-+-+ +-+ + +-+-+-+ + + + + +-+ +-+ +-+-+ + + + + + +-+-+ +-+ +-+-+ +-+ +-+-+-+-+ + +-+ +-+-+-+-+ + + + + +-+-+ +-+
| |   |   | |   | | |     | |   | | | | |   | |   |   | | |   | |     |   |     | |     |     | |     |       | | |   | |   | | |
+ +-+ +-+ + + + + + +-+-+ + + +-+ +-+-+ + + +-+ + + + +-+-+ + +-+-+-+ +-+-+-+ +-+ +-+ +-+-+ +-+-+-+-+ + +-+-+-+-+ + +-+-+-+ + + +
|           | | | |       | | |   |     | |     |   | |   | | | | | |   |   |   |   |         |   |     |     |       |         |
+ +-+-+-+ + + +-+ +-+-+-+-+ + + + + +-+-+-+-+-+ +-+-+-+-+ +-+ + + + + + + +-+-+ +-+-+-+-+ + +-+ +-+ +-+-+ +-+-+-+ +-+ + +-+ +-+ +
| |       |       |     |       | | |     |           | |         |   |     |     | |   | |   |   |     | |     | |       | | | |
+-+-+-+-+ +-+-+-+-+ +-+-+ +-+ + +-+-+ +-+ + +-+ +-+ + + + +-+ +-+-+-+-+-+-+ + +-+ + + + + + +-+ + + + + + +-+ +-+-+-+-+ +-+-+ + +
|     | | |   |           |   |   |   | |   | | |   |   | |       | |   |   |   | |   |   |     |   | |           |   | |       |
+ +-+-+ +-+-+ +-+ + +-+ +-+-+-+ +-+-+ + + +-+ + +-+ +-+-+ +-+-+-+ + + + + + + +-+-+-+-+-+-+ +-+ + + +-+-+-+-+ +-+-+-+ + +-+-+-+ +
|       |   |     |   | |   | |   | | |       | | |     | |   |     | |   | |           | |   | | |       |     | |   | |   | | |
+-+-+ +-+-+ +-+ +-+ +-+-+-+ + +-+ + + + + +-+-+ + +-+ +-+ + +-+-+ + +-+-+ + +-+ +-+-+ +-+ + +-+ +-+-+ +-+-+-+-+ + + +-+-+ +-+ + +
|   | | | |   |   | | | |       |   | | |   |     |   |       |   |   |   | |   |       |   | |   | |   |   |           |       |
+ +-+ + + + + +-+ + + + +-+ + +-+ + +-+ + +-+-+ + +-+-+-+-+ +-+-+-+-+-+-+ +-+ + +-+-+ +-+ +-+ + +-+ +-+-+-+ +-+-+ +-+-+-+-+-+-+ +
|     | | | | | | |         |   | | |   |     | | | | | |     |   |     | |   |     |       |   | |     |   |   | |       |     |
+-+ +-+ + + + + + +-+-+ +-+-+-+-+ +-+-+ + +-+-+-+-+ + + + +-+-+ +-+ +-+ + + + +-+-+-+ +-+-+-+ + + + +-+-+ + + + + + +-+ +-+-+ +-+
|   |   |   |       |   |   |   |     | | |       | |   |         | |     | | |   |   |   |   | | |   |   |   |   |   |     |   |
+-+ + +-+-+ +-+-+ +-+-+ +-+ +-+ +-+-+ +-+ +-+ +-+ + + + +-+-+-+ + + + +-+ + + + +-+-+ + +-+-+ +-+ + +-+-+ +-+ + +-+-+-+ +-+ +-+-+
|     | |   | | |   | |     |           |     | | | | |     |   |   |   | | |     |       |       |       |   |         |   |   |
+ + +-+ +-+-+ + + + + +-+-+-+ + + +-+-+-+-+ + + + + +-+ +-+ +-+ +-+-+ +-+ +-+-+ + +-+-+-+ +-+ +-+-+ +-+-+-+-+-+-+ +-+ + +-+-+ +-+
| |   |       |   | |       | | | | |       | |   |     | | | | |     | | |   | |     | | | | |       |   |     |   | | |   |   |
+-+-+ +-+ +-+ + + + +-+-+-+ +-+-+ + +-+ + +-+ + +-+-+ +-+ +-+ + + + +-+ + + + +-+-+ + + + + + +-+-+-+-+ +-+-+ + + +-+-+ +-+ + +-+
|     | | |     | | | |       | | | |   | |   |     | |     | | | | | | |   | |   | | |   |   | | |   |   |   |   |         |   |
+-+ +-+ + + + +-+ +-+ + +-+-+ + +-+ +-+ +-+-+-+-+-+ + +-+ +-+ + +-+-+ + +-+-+-+ + + +-+ + +-+-+ + + +-+ +-+-+-+ +-+ + +-+-+ + + +
|         | | |   |         |   |             |   |   |     | | |       |     | | |   | |         |     | |     | | |     |   | |
+-+ +-+-+-+-+ + +-+ + +-+ + + +-+-+-+-+-+-+-+ + + +-+-+-+ +-+ + +-+-+-+ + +-+-+ + + +-+-+-+ + +-+-+-+ +-+ +-+-+-+ +-+ + + +-+ +-+
|           | |   | | | | | |         | |   |   | |   |   | |           |   |   |       |   |   |       | | |     |   | |   | | |
+-+ +-+ +-+-+-+-+-+ + + +-+-+ +-+ + + + + + +-+-+ +-+ +-+ + +-+-+-+-+-+ +-+ +-+ +-+-+-+-+ +-+-+-+ +-+-+-+ + + + + +-+-+ +-+-+ + +
|     |   | |     | | | |   | |   | |     |   | |     |           | | | |     | |     |           | | | |     | |         |     |
+-+ + + +-+ +-+-+ +-+-+ +-+ +-+-+ +-+-+ +-+-+ + +-+ +-+-+-+-+ +-+ + + + +-+ +-+-+ +-+-+-+-+-+-+ + + + + + + +-+ + +-+-+-+ +-+-+ +
| | | |   |   | | |           |   | |   | | |   |     | |   | |       |   | | |           |     | |     | | | | |   |     | | | |
+ + + + +-+ +-+ + + + +-+-+ +-+-+ + + + + + + + +-+ + + +-+ + + +-+-+-+-+ + + + + +-+-+-+-+-+-+ +-+ +-+ +-+ + + +-+ + +-+-+ + + +
| | | |       |   | | |   |   |     | |   | | |     |       | |   |     |   |   | |           |   |   | | | |   |   | |   |     |
+ + +-+ +-+ +-+-+ +-+ +-+ +-+-+ + + +-+ + + + +-+-+-+ +-+ + +-+ + + +-+ + + + + +-+-+ +-+-+ + + +-+ + +-+ + +-+ +-+-+-+-+ +-+ + +
|   |     |   |   |   |   |   | | |   | | |     |       | |     |   |   | |   |     |   |   | | | | | |   |   | | |       |   | |
+ + +-+-+ +-+-+-+ +-+ + +-+-+ + +-+ +-+-+ +-+-+ + +-+ +-+-+ + +-+ +-+-+-+-+-+ +-+-+-+ +-+-+ +-+ + +-+ +-+ + + +-+ + +-+ + + +-+ +
| | |   |               |         | |   | | | | | | | |     |   | |   |   |   |   |   |           |   | |   |   |   |   |     | |
+-+ + +-+-+-+-+-+ + +-+ + +-+ + +-+ +-+ +-+ + + +-+ +-+ +-+-+ +-+-+ +-+-+ +-+ + +-+ +-+ +-+ + +-+-+ + + + + +-+ +-+ + + +-+-+ + +
|               | |   |   |   | |         |         |       |       |         |     |     | |   |   |     |   | |   | | |     |X|
+-+-+-+-+-+-+-+-+-+-+-+-+-+-+-+-+-+-+-+-+-+-+-+-+-+-+-+-+-+-+-+-+-+-+-+-+-+-+-+-+-+-+-+-+-+-+-+-+-+-+-+-+-+-+-+-+-+-+-+-+-+-+-+-+
 