+-+-+-+-+-+-+-+-+-+-+-+-+-+-+-+-+
|S          |   |       |   | | |
+ +-+ +-+ +-+ +-+ +-+ +-+-+ + + +
| | | |   |     |   | |   | |   |
+ + +-+-+-+-+-+ + + +-+-+ + +-+ +
|   |   | | |   | |   |   | |   |
+ + + +-+ + + +-+-+-+ +-+ + + +-+
| | |     |     | |             |
+ + +-+ +-+ + +-+ + + +-+ +-+ +-+
| |       | |   |   |   | |     |
+ + +-+-+-+ +-+ +-+-+ +-+-+-+-+ +
| |         | | |           |   |
+-+-+ +-+-+ + + + + + + + +-+ +-+
| | |     |   | | | | | |   |   |
+ + + +-+-+ + +-+-+ +-+-+-+ + + +
|     |   | | |     |       | | |
+-+-+ + +-+ + +-+-+-+-+-+ +-+-+ +
|         | |   |   |     |     |
+ +-+ +-+-+ + + +-+ + + +-+-+ +-+
| | | |   | | | | |   | |   |   |
+ + +-+ +-+-+ + + +-+ + + +-+-+ +
| | |       | |   |   |       | |
+-+ +-+ +-+-+ + +-+-+-+-+-+-+ +-+
|     |     | |     |     |     |
+ + + + + +-+-+ + +-+ +-+-+ + + +
| | | | |   | | |           | | |
+ +-+-+-+ + + +-+ +-+-+-+ + +-+ +
|       | | |         | | | |   |
+-+-+-+ + +-+-+ +-+-+ + + + + + +
|       |     |   |   |   | | | |
+-+ +-+ + +-+-+-+-+ +-+-+-+-+-+ +
|   |                     |    X|
+-+-+-+-+-+-+-+-+-+-+-+-+-+-+-+-+
 