+-+-+-+-+-+-+-+-+-+-+-+-+-+-+-+-+
|S| | | |             |         |
+ + + + +-+ + +-+ +-+ +-+ +-+ +-+
|     | | | |   | | | |     | | |
+-+ +-+ + + +-+ +-+ +-+ + +-+-+ +
| |   | |     | |       |   |   |
+ + + + +-+ +-+-+ +-+-+-+-+ + + +
|   |   |       |   |     |   | |
+-+-+-+ + + +-+ + +-+ + +-+-+ +-+
|       | | |     | | |       | |
+ +-+-+-+-+-+ +-+-+ +-+-+-+-+ + +
|     |       | |     |     |   |
+ +-+-+-+ +-+ + + + +-+-+ +-+ + +
|     | | |       | |       | | |
+-+ +-+ +-+-+ +-+ +-+-+ + + +-+-+
| |       |   |       | | | |   |
+ +-+-+ +-+-+ +-+ +-+-+-+ + +-+ +
|   |     |   |       |   | |   |
+ + + +-+-+ +-+-+-+-+ +-+ +-+-+ +
| |         |   |   |     | |   |
+-+-+ + + +-+-+ +-+ + +-+ + + + +
|   | | | |           |   |   | |
+ + + + + + +-+ + + +-+-+-+-+-+ +
| |   | | |   | | |   | |       |
+-+-+-+ +-+-+ +-+ +-+-+ +-+ + +-+
|           | |       |   | |   |
+-+ + +-+-+-+-+-+-+-+ + +-+-+ + +
|   |   | |   |   |         | | |
+ + +-+ + +-+ + +-+-+ +-+-+ + +-+
| | |             |       | | | |
+ +-+-+-+-+-+ + +-+ +-+ + + + + +
|         |   |   |   | | |    X|
+-+-+-+-+-+-+-+-+-+-+-+-+-+-+-+-+
 