+-+-+-+-+-+-+-+-+-+-+-+-+-+-+-+-+
|S| | | | 2 8 1 8 6 8 | 2 4 7 2 |
+6+5+6+8+-+6+5+-+7+-+1+-+8+-+2+-+
| 9 9 | | | | 7 | | | | 7 9 | | |
+-+9+-+9+5+2+-+2+-+6+-+1+1+-+-+4+
| | 6 | | 4 2 | | 8 5 8 | 7 | 1 |
+1+3+6+5+-+6+-+-+3+-+-+-+-+3+4+3+
| 2 | 2 | 9 9 1 | 6 | 6 5 | 5 | |
+-+-+-+7+1+6+-+7+3+-+9+8+-+-+4+-+
| 5 3 1 | | | 1 1 | | | 1 3 7 | |
+3+-+-+-+-+-+6+-+-+7+-+-+-+-+6+8+
| 7 7 | 9 6 4 | | 7 3 | 9 2 | 7 |
+7+-+-+-+9+-+1+2+2+8+-+-+1+-+4+3+
| 1 2 | | | 3 2 9 | | 4 6 3 | | |
+-+7+-+1+-+-+8+-+3+-+-+8+3+9+-+-+
| | 2 7 6 | 2 | 6 5 7 | | | | 1 |
+5+-+-+7+-+-+3+-+4+-+-+-+3+1+-+5+
| 4 | 8 6 | 4 | 7 6 5 | 3 | | 6 |
+3+2+4+-+-+3+-+-+-+-+9+-+4+-+-+3+
| | 1 1 8 3 | 5 | 4 | 7 3 | | 6 |
+-+-+2+3+7+-+-+5+-+3+3+-+8+9+6+2+
| 6 | | | | 2 5 9 5 7 | 8 | 6 | |
+9+7+1+9+5+1+-+8+5+3+-+-+-+-+-+9+
| | 2 | | | 6 | | | 3 | | 4 8 9 |
+-+-+-+8+-+-+9+-+2+-+-+4+-+8+6+-+
| 3 4 7 7 1 | | 3 2 8 | 8 | | 9 |
+-+3+6+-+-+-+-+-+-+-+8+8+-+-+5+4+
| 1 | 7 | | 1 | 3 | 1 3 4 7 | | |
+3+9+-+6+2+-+3+2+-+-+7+-+-+3+3+-+
| | | 3 8 4 3 7 9 | 8 4 1 | | | |
+5+-+-+-+-+-+3+6+-+9+-+4+6+4+5+6+
| 5 5 9 2 | 7 | 8 | 5 | | | 7 8X|
+-+-+-+-+-+-+-+-+-+-+-+-+-+-+-+-+
